00000000000000000000
00000000000000000000
00000000000000000000
00000000000000000000
01100000000000000000
00000000000000000000
00000000000001110000
00000000000000000000
00000000000000000000
00011111110000000000
00000000000010000000
00000000000000000000
00000011000000000000
00000000000000000000
00000000000000000000
00000000011000000111
01110000110000000000
00000000000000000000
00000000000000000000
00000000000000000000